 000 000 000 000 000 000 000 000 000 000 000 000 000 000 000 000 000 000 000 000 000 000 000 000 000 000 000 000 000 000 000 000
 000 000 000 000 000 000 000 000 000 000 000 000 000 000 000 000 000 000 000 000 000 000 000 000 000 000 000 000 000 000 000 000
 000 000 000 000 000 000 000 000 000 000 000 000 000 000 000 000 000 000 000 000 000 000 000 000 000 000 000 000 000 000 000 000
 000 000 000 000 000 000 000 000 000 000 000 000 000 000 000 000 000 000 000 000 000 000 000 000 000 000 000 000 000 000 000 000
 000 000 000 000 000 000 000 000 000 000 000 000 000 000 000 000 000 000 000 000 000 000 000 000 000 000 000 000 000 000 000 000
 000 000 000 000 000 000 000 000 000 000 000 000 000 000 000 000 000 000 000 000 000 000 000 000 000 000 000 000 000 000 000 000
 000 000 000 000 000 000 000 000 000 000 000 000 000 000 158 158 158 158 158 000 000 000 000 000 000 000 000 000 000 000 000 000
 000 000 000 000 000 000 000 000 000 000 000 158 158 158 240 240 240 240 240 158 158 158 000 000 000 000 000 000 000 000 000 000
 000 000 000 000 000 000 000 000 158 158 158 240 240 240 240 240 240 240 240 240 240 240 158 158 158 000 000 000 000 000 000 000
 000 000 000 000 000 000 000 158 240 240 240 240 240 240 240 240 240 240 240 240 240 240 240 240 240 158 000 000 000 000 000 000
 000 000 000 000 000 000 158 240 240 240 240 240 240 240 240 240 240 240 240 240 240 240 240 240 240 240 158 000 000 000 000 000
 000 000 000 000 000 000 158 240 240 240 240 240 240 242 240 240 240 240 240 240 240 240 240 240 240 240 158 000 000 000 000 000
 000 000 000 000 000 000 158 240 240 240 240 240 240 240 240 240 240 240 240 240 240 240 240 240 240 240 158 000 000 000 000 000
 000 000 000 000 000 158 240 240 240 240 240 240 240 240 240 240 240 240 240 240 240 240 240 240 240 240 240 158 000 000 000 000
 000 000 000 000 000 158 240 240 169 240 240 169 240 240 240 240 240 240 240 240 240 169 240 240 169 240 240 158 000 000 000 000
 000 000 000 000 000 158 240 240 240 240 240 240 240 240 240 240 240 240 240 240 240 240 240 240 240 240 240 158 000 000 000 000
 000 000 000 000 000 158 240 240 169 240 240 169 240 240 240 240 240 240 240 240 240 169 240 240 169 240 240 158 000 000 000 000
 000 000 000 000 000 158 240 240 240 240 240 240 240 240 240 240 240 240 240 240 240 240 240 240 240 240 240 158 000 000 000 000
 000 000 000 000 000 000 158 240 240 240 240 240 240 240 240 240 240 240 240 240 240 240 240 240 240 240 158 000 000 000 000 000
 000 000 000 000 000 000 158 240 240 240 240 240 240 240 240 240 240 240 240 240 240 240 240 240 240 240 158 000 000 000 000 000
 000 000 000 000 000 000 158 240 240 240 240 240 240 240 240 240 240 240 240 240 240 240 240 240 240 240 158 000 000 000 000 000
 000 000 000 000 000 000 000 158 240 240 240 240 240 240 240 240 240 240 240 240 240 240 240 240 240 158 000 000 000 000 000 000
 000 000 000 000 000 000 000 000 158 158 158 240 240 240 240 240 240 240 240 240 240 240 158 158 158 000 000 000 000 000 000 000
 000 000 000 000 000 000 000 000 000 000 000 158 158 158 240 240 240 240 240 158 158 158 000 000 000 000 000 000 000 000 000 000
 000 000 000 000 000 000 000 000 000 000 000 000 000 000 158 158 158 158 158 000 000 000 000 000 000 000 000 000 000 000 000 000
 000 000 000 000 000 000 000 000 000 000 000 000 000 000 000 000 000 000 000 000 000 000 000 000 000 000 000 000 000 000 000 000
 000 000 000 000 000 000 000 000 000 000 000 000 000 000 000 000 000 000 000 000 000 000 000 000 000 000 000 000 000 000 000 000
 000 000 000 000 000 000 000 000 000 000 000 000 000 000 000 000 000 000 000 000 000 000 000 000 000 000 000 000 000 000 000 000
 000 000 000 000 000 000 000 000 000 000 000 000 000 000 000 000 000 000 000 000 000 000 000 000 000 000 000 000 000 000 000 000
 000 000 000 000 000 000 000 000 000 000 000 000 000 000 000 000 000 000 000 000 000 000 000 000 000 000 000 000 000 000 000 000
 000 000 000 000 000 000 000 000 000 000 000 000 000 000 000 000 000 000 000 000 000 000 000 000 000 000 000 000 000 000 000 000
 000 000 000 000 000 000 000 000 000 000 000 000 000 000 000 000 000 000 000 000 000 000 000 000 000 000 000 000 000 000 000 000
